10 10
..#.#.###.
#...#...#.
#.#####.#.
#.#...#...
#.#.#...#.
#.#.###.#.
........#.
.#.####.#.
.#.####.#.
.#......#.
