10 10
11 1 1   1
 111 111 1
 1     1 1
 1 111 111
 1 1 111 1
 1 1   1 1
11111111 1
1 1    1 1
1 1    1 1
1 111111 1
