25 15
...........#...#...#...##
.###.###.#.#.#.#.#.#.#.##
.###.###.#.#.#.#.#.#.#.##
..#...#..#...............
#.#.#.#.########.#.#.#.#.
....#...####...#.#.#.#.#.
.###########.###...#...#.
...........#...##.####.#.
##########.#.####.####.#.
...........#...##......#.
.####.###########.####.#.
..........#...#........#.
.########.#.#.#.#.####.#.
.#...#....#.#.#.#.####.#.
...#...##...#...#......#.
